Ryan Hoover - Founder of Product Hunt
Marissa Meyer - Former CEO of Yahoo
Elon Musk - Founder of Tesla, SpaceX
Jeff Bezos - Founder of Amazon
Sheryl Sandberg - COO of Facebook
Oprah - Founder at Oprah Winfrey Network
Kim Kardashian - Entrepreneur and Celebrity
Marc Benioff - CEO of Salesforce
Keith Rabois - Entrepreneur, Investor (PayPal, Linkedin, Square, Opendoor)
Palmer Luckey - Founder of Oculus, Anduril
Patrick Collison - Founder of Stripe
Sam Altman - President of YCombinator and Chairman of OpenAI
Paul Graham - Cofounder of YCombinator
Ryan Peterson - Founder of Flexport
Danielle Morrill - Early at Twilio, Founder of Mattermark
Elad Gil - Investor and Entrepreneur (Color Genomics)
Peter Thiel - Entrepreneur, Investor (Paypal, Facebook, Palantir, Founders Fund, etc.)
Katrina Lake - Founder and CEO of Stitch Fix
April Underwood - Chief Product Officer of Slack
Kanye West - Artist, Producer
Tim Ferris - Author and Podcaster
Stewart Butterfield - Founder of Slack
Michael Dell - Founder of Dell
Marc Andreessen - Venture Capitalist at a16z
Steve Jobs - Founder of Apple 
Jack Ma - Founder of Alibaba Group
Adam Neumann - Founder of WeWork
Max Levchin - Founder of PayPal, Slide, Affirm
Mark Zuckerberg - Founder of Facebook
Brian Armstrong - CEO of Coinbase
Vitalik Buterin - Founder of Ethereum
Larry Ellison - Founder of Oracle
Bill Gates - Founder of Microsoft
Tobias Lutke - Founder of Shopify
Manjit Minhas - Investor and Founder of Minhas Breweries
Michele Romanow - Investor and Founder of Clearbanc
Arlene Dickinson - Investor and CEO of Venture Communications
Barbara Corcoran - Investor and Shark on Shark Tank
Lori Greiner - Entrepreneur and Shark on Shark Tank
Jessica Livingston - Cofounder of YCombinator
